00000000000000000000000000000000000000000000000000000000
01111111111111111111111111100111111111111111111111111110
01111111111111111111111111100111111111111111111111111110
01121212121212121212121212100112121212121212121212121210
01111111111111111111111111100111111111111111111111111110
01121000000112100000000112111112100000000112100000011210
01111011110111101111110111111111101111110111101111011110
01121011110112101111110112121212101111110112101111011210
01111000000111100000000111111111100000000111100000011110
01121111111112111111111112100112111111111112111111111210
01111111111111111111111111100111111111111111111111111110
01121218121212121212121212100112121212121212121218121210
01111111111111111111111111100111111111111111111111111110
01121000000112100112100000000000000112100112100000011210
01111000000111100111100000000000000111100111100000011110
01121111111112100112111111100111111112100112111111111210
01111111111111100111111111100111111111100111111111111110
01121212121212100112121212100112121212100112121212121210
01111111111111100111111111100111111111100111111111111110
00000112100112100000000112100112100000000112100112100000
00000111100111100000000111100111100000000111100111100000
01111112100112111111111112111112111111111112100112111110
01111111100111111111111111111111111111111111100111111110
01121212100112121212121212121212121212121212100112121210
01111111100111111111111111111111111111111111100111111110
01121000000112100112100001111110000112100112100000011210
01111000000111100111101111111111110111100111100000011110
01121111111112100112101111111111110112100112111111111210
01111111111111100111101111111111110111100111111111111110
01121212121212100112101111111111110112100112121212121210
01111111111111100111101111111111110111100111111111111110
01121000000112100112101111111111110112100112100000011210
01111000000111100111100000000000000111100111100000011110
01121111100112100112111111111111111112100112100111111210
01111111100111100111111111111111111111100111100111111110
01121212100112100112121212121212121212100112100112121210
01111111100111100111111111111111111111100111100111111110
00000112100112100112100000000000000112100112100112100000
00000111100111100111100000000000000111100111100111100000
01111112111112111112111111111111111112111112111112111110
01111111111111111111111111111111111111111111111111111110
01121212121212121212121212121112121212121212121212121210
01111111111111111111111111111111111111111111111111111110
01121000000112100000000112100112100000000112100000011210
01111000000111100000000111100111100000000111100000011110
01121111100112111111111112100112111111111112100111111210
01111111100111111111111111100111111111111111100111111110
01121218100112121212121212100112121212121212100118121210
01111111100111111111111111100111111111111111100111111110
00000112100112100112100000000000000112100112100112100000
00000111100111100111100000000000000111100111100111100000
01111112111112100112111111100111111112100112111112111110
01111111111111100111111111100111111111100111111111111110
01121212121212100112121212100112121212100112121212121210
01111111111111100111111111100111111111100111111111111110
01121000000112100000000112100112100000000112100000011210
01111000000111100000000111100111100000000111100000011110
01121111111112111111111112111112111111111112111111111210
01111111111111111111111111111111111111111111111111111110
01121212121212121212121212121212121212121212121212121210
01111111111111111111111111111111111111111111111111111110
00000000000000000000000000000000000000000000000000000000
